3
7
3 3
35 31
x 0 0 x x x 0 0 0 0 0 0 0 0 0 0 0 0 0 0 0 0 0 0 0 0 0 0 0 0 x 
x 3 0 0 0 0 0 0 0 0 0 0 0 0 b 0 0 0 0 0 0 0 0 0 0 0 0 0 0 0 x 
x 0 0 0 0 0 0 0 0 0 0 0 0 0 0 0 0 0 0 0 0 0 0 0 0 0 0 0 0 0 x 
- - - 0 0 0 - - - - - - - - - - - - - - - - - - - - - - 0 0 0 
- - - 0 0 0 - - - - - - - - - - - - - - - - - - - - - - 0 0 0 
- - - 0 0 0 - - - - - - - - - - - - - - - - - - - - - - 0 0 0 
- - - 0 0 0 - - - - - - x 0 0 0 0 0 0 0 0 0 0 0 0 0 0 0 x x x 
- - - 0 0 0 - - - - - - x 0 1 0 0 0 0 0 0 0 0 0 0 0 b 0 x x x 
- - - 0 0 0 - - - - - - x 0 0 0 0 0 0 0 0 0 0 0 0 0 0 0 x x x 
- - - 0 0 0 - - - - - - - - - - - - - - 0 0 0 - - - - - - - - 
- - - 0 0 0 - - - - - - - - - - - - - - 0 0 0 - - - - - - - - 
- - - 0 0 0 - - - - - - - - - - - - - - 0 0 0 - - - - - - - - 
- - - 0 0 0 0 0 0 0 0 0 0 0 0 0 0 x x x 0 0 0 0 0 0 0 0 0 0 0 
- - - 0 0 0 0 3 0 b 0 0 0 0 0 0 0 x x x 0 0 0 0 0 0 0 0 0 2 0 
- - - 0 0 0 0 0 0 0 0 0 0 0 0 0 0 x x x 0 0 0 0 0 0 0 0 0 0 0 
- - - 0 0 0 - - - - - - - - - - - 0 0 0 - - - - - - - - 0 0 0 
- - - 0 0 0 - - - - - - - - - - - 0 0 0 - - - - - - - - 0 0 0 
- - - 0 0 0 - - - - - - - - - - - 0 0 0 - - - - - - - - 0 0 0 
- - - 0 0 0 0 0 0 0 x x x 0 0 0 0 0 0 0 - - - - - - - - 0 0 0 
- - - 0 0 0 0 0 0 0 x x x 0 0 0 0 0 b 0 - - - - - - - - 0 0 0 
- - - 0 0 0 0 0 0 0 x x x 0 0 0 0 0 0 0 - - - - - - - - 0 0 0 
- - - 0 0 0 - - - - 0 0 0 - - - - 0 0 0 0 0 0 0 0 x - - 0 0 0 
- - - 0 0 0 - - - - 0 0 0 - - - - 0 0 0 0 0 0 i 0 x - - 0 0 0 
- - - 0 0 0 - - - - 0 0 0 - - - - x x x 0 0 0 0 0 x - - 0 0 0 
- - - 0 0 0 - - - - 0 0 0 - - - - - - - - - - - - - - - 0 0 0 
- - - 0 c 0 - - - - 0 0 0 - - - - - - - - - - - - - - - 0 0 0 
- - - 0 0 0 - - - - 0 0 0 - - - - - - - - - - - - - - - 0 0 0 
- - - 0 2 0 - - - - 0 0 0 - - - - x 0 0 0 0 0 0 0 0 0 0 0 0 0 
- - - x x x - - - - 0 0 0 - - - - x b 0 0 0 0 0 0 0 0 0 0 b 0 
- - - - - - - - - - 0 0 0 - - - - x 0 0 0 0 0 0 0 0 0 0 x x x 
- - - - - - - - - - 0 0 0 - - - - - - - - - - - - - - - - - - 
- - - - - - - - - - 0 0 0 - - - - - - - - - - - - - - - - - - 
x 0 0 0 0 0 0 0 0 0 x x x 0 0 0 0 0 0 0 0 0 0 0 0 0 0 0 0 0 x 
x 0 b 0 0 0 0 0 0 0 x x x 0 0 0 0 0 0 0 0 0 0 0 0 0 0 0 0 1 x 
x 0 0 0 0 0 0 0 0 0 x x x 0 0 0 0 0 0 0 0 0 0 0 0 0 0 0 0 0 x 
12 8 6 <-> 5 8 2
5 7 2 <-> 12 7 6
12 6 6 <-> 5 6 2
25 21 2 <-> 28 21 6
25 22 2 <-> 28 22 6
25 23 2 <-> 28 23 6
17 27 0 <-> 17 23 4
19 27 0 <-> 19 23 4
18 27 0 <-> 18 23 4
3 32 0 <-> 3 28 4
4 28 4 <-> 4 32 0
5 32 0 <-> 5 28 4
17 29 6 <-> 12 29 2
17 28 6 <-> 12 28 2
12 18 1 <-> 17 14 5
10 20 5 <-> 10 32 7
12 32 1 <-> 17 20 5
10 34 5 <-> 0 34 4
0 32 0 <-> 12 34 3
12 20 3 <-> 30 29 3
