4
3
4 1
25 100
- - - - - - - - - - - - - - - - - - - - - 0 0 0 0 0 0 0 0 0 0 0 0 0 0 0 0 0 0 0 0 0 0 0 - - - - - - - - - - - - - - - - - - - - - - - - - - - - - - - - - - - - - - - - - - - - - - - - - - - - - - - -
- - - - - - - - - - - - - - - - - 0 0 0 0 0 0 0 0 0 0 0 0 0 0 0 0 0 0 0 0 0 0 0 0 0 0 - - - - - - - 0 0 2 2 2 - - - - - - - - - - - - - - - - - 1 1 1 1 4 - - - - - - - - - - - - - - - - - - - - - - -
- - - - - - - - - - - - 0 0 0 0 0 0 0 0 0 0 0 0 0 0 - 0 0 0 0 0 0 0 0 0 0 0 0 0 0 0 - - - - - - - - 0 0 0 2 - - - - - - - - 0 2 0 0 - - - - - 1 0 1 0 4 0 4 0 - - - - - - 0 0 0 0 - - - - - - - - - - -
- - 0 0 0 - - - - - - - 0 0 0 0 0 0 0 0 0 0 0 0 0 0 0 0 - - - 0 0 0 0 0 0 0 0 0 0 0 - - - - - - - - - - - 3 2 - - - - - - 0 2 - - 1 1 1 1 1 1 1 1 1 4 4 1 4 4 1 1 1 0 0 0 0 0 0 0 0 0 - - - - - 0 0 - -
0 0 0 0 0 0 0 0 0 0 0 0 0 0 0 0 0 0 0 0 0 0 0 0 0 0 0 0 0 0 - 0 0 0 0 0 0 0 0 0 0 - - - - - - - - - 0 0 0 3 0 2 0 2 0 2 0 2 0 0 0 0 0 0 0 4 0 1 4 1 0 4 0 1 0 4 0 0 0 0 0 0 0 0 0 0 0 0 0 0 0 0 0 0 0 0
0 0 0 0 0 0 0 0 0 0 0 0 0 0 0 0 0 0 0 0 0 0 0 0 0 0 0 0 0 0 - - 0 0 0 0 0 - - - 0 0 0 - - - - - 0 0 0 2 2 2 2 2 2 0 2 0 2 0 3 0 0 0 0 0 4 4 1 1 4 1 1 1 1 1 1 1 1 1 0 0 0 0 0 0 0 0 0 0 0 0 0 0 0 0 0 0
0 0 0 0 0 0 0 0 0 0 0 0 0 0 0 0 0 0 0 0 0 0 - - - 0 0 0 0 0 - - - 0 0 - - - - - - - - - - 0 0 - 0 0 0 2 0 2 0 2 0 2 0 2 0 3 0 0 0 0 0 0 0 1 0 1 4 1 0 1 0 4 0 1 0 0 0 0 0 0 0 0 0 0 0 0 0 0 0 - - - - -
- 0 0 0 - - - - - 0 0 0 0 0 0 0 0 0 0 0 0 0 0 0 0 0 0 0 0 0 0 0 - - - - - - - - - - - - 0 0 0 0 0 0 0 2 2 3 2 0 3 0 2 0 3 0 2 0 0 0 0 4 1 4 4 4 4 4 0 4 4 4 1 1 4 0 0 0 0 0 0 - - - 0 0 0 - - - - - - -
- - - - - - - - - - - 0 0 0 0 0 0 0 0 0 0 0 0 0 0 0 0 0 0 0 0 0 0 - - - - - - - - - - - 0 0 0 0 0 0 0 2 0 3 0 2 0 2 0 3 0 2 0 0 0 0 0 4 0 4 4 4 4 0 0 4 0 1 0 0 0 4 0 0 0 0 0 - - - 0 - - - - - - - - -
- - - - - - - - - - - - 0 0 0 0 0 0 0 0 0 0 0 0 0 0 0 0 0 0 - - - - - - - - - - - - - - 0 0 0 0 0 2 3 2 2 2 3 2 2 0 3 0 3 0 2 0 0 0 0 4 4 4 4 4 4 0 0 0 1 0 4 0 0 0 0 0 0 0 0 0 - - - - - - - - - - - -
- - - - - - - - - - - - 0 0 0 0 0 0 0 0 0 0 0 0 0 0 0 - - - - - - - - - - - - - - - - - 0 0 0 0 0 3 0 3 0 3 0 3 0 3 0 2 0 2 0 2 0 0 0 4 0 4 0 1 4 4 0 0 0 0 0 4 0 0 0 0 0 0 0 - - - - - - - - - - - - -
- - - - - - - - - - - - - - 0 0 0 0 0 0 0 0 0 0 0 - - - - - - - - - - - - - - - - - - 0 0 0 0 0 3 2 0 3 3 3 3 0 3 0 0 0 2 0 3 0 2 0 0 0 0 4 0 0 0 0 4 0 0 0 0 0 0 - - 0 0 - - - - - - - - - - - - - - -
- - - - - - - - - - - - - - - 0 0 0 0 0 - - 0 0 0 0 - - - - - - - - - - - - - - - - 0 0 0 0 0 0 0 0 0 0 0 2 0 3 0 0 0 0 0 0 0 3 0 0 0 0 0 4 0 0 0 0 0 0 0 0 0 0 0 - - - - - - - - - - - - - - - - - - -
- - - 0 - - - - - - - - - - - - - 0 0 0 0 0 0 0 - 0 0 0 0 - - - - - - - - - - - - - 0 0 0 0 0 0 0 0 0 3 3 2 3 3 3 0 0 0 0 0 0 - - - - 0 0 0 0 - 0 0 0 0 0 0 - - 0 - - - - - - - - - - - - - - - - - - -
- - - - - - - - - - - - - - - - - - - - - - 0 0 0 0 0 0 0 0 0 - - - - - - - - - - - 0 0 0 0 0 0 0 0 0 0 0 3 3 3 0 0 0 0 0 0 - - - - - 0 0 0 - - - - 0 0 0 0 - 0 0 0 - - - - - - - - - - - - - - - - - -
- - - - - - - - - - - - - - - - - - - - - - - - 0 0 0 0 0 0 0 0 0 - - - - - - - - - - - 0 0 0 0 0 0 0 0 2 2 3 3 2 0 0 0 0 - - - - - - - - 0 - - - 0 0 0 - 0 0 0 0 0 0 - - - - - - - - - - - - - - - - -
- - - - - - - - - - - - - - - - - - - - - - - - 0 0 0 0 0 0 0 0 0 0 0 0 0 0 - - - - - - - - - - - 0 0 0 0 2 0 0 3 2 0 - - - - - - - - - - - - - - - 0 0 0 0 0 0 0 0 0 0 0 0 0 0 0 0 - - - - - - - - - -
- - - - - - - - - - - - - - - - - - - - - - - - - 0 0 0 0 0 0 0 0 0 0 0 0 0 - - - - - - - - - - - - 0 0 0 2 0 0 0 0 0 - 0 - - - - - - - - - - - - - - - - 0 0 0 0 0 0 0 0 0 0 0 0 - - - - - - - - - - -
- - - - - - - - - - - - - - - - - - - - - - - - - - 0 0 0 0 0 0 0 0 0 0 0 - - - - - - - - - - - - - 0 0 0 0 0 0 0 0 0 0 0 - - - - - - - - - - - - - - - - - - 0 0 0 0 0 0 0 0 0 0 - - - 0 - - - 0 - - -
- - - - - - - - - - - - - - - - - - - - - - - - - - - 0 0 0 0 0 0 0 0 0 - - - - - - - - - - - - - - 0 0 0 0 0 0 0 - - 0 0 - - - - - - - - - - - - - - - - - 0 0 0 0 0 0 0 0 0 0 0 0 - - - - - - - - - -
- - - - - - - - - - - - - - - - - - - - - - - - - - 0 0 0 0 0 0 0 0 - - - - - - - - - - - - - - - - - 0 0 0 0 0 - - - - - - - - - - - - - - - - - - - - - - 0 0 0 0 0 0 0 0 0 0 0 0 - - - - - - - - - -
- - - - - - - - - - - - - - - - - - - - - - - - - - 0 0 0 0 0 0 - - - - - - - - - - - - - - - - - - - - - - - - - - - - - - - - - - - - - - - - - - - - - - - - - - - - - 0 0 0 0 - - - - - 0 0 0 - - -
- - - - - - - - - - - - - - - - - - - - - - - - - - 0 0 0 0 - - - - - - - - - - - - - - - - - - - - - - - - - - - - - - - - - - - - - - - - - - - - - - - - - - - - - - - - - b - - - - - 0 0 0 - - - -
- - - - - - - - - - - - - - - - - - - - - - - - - - 0 0 0 - b - - - - - - - - - - - - - - - - - - - - - - - - - - - - - - - - - - - 0 - - - - - - - - - - - - - - - - - - - - - - - - - - - - - - - - -
- - - - - - - - - - - - - - - - - - - - - - - - - - 0 0 0 - - - - - - - - - - - - - - - - - - - - - - - - - - - - - - - - - - - - - - - - - - - - - - - - - - - - - - - - - - - - - - - - - - - - - - -
99 4 2 <-> 0 4 6
0 5 6 <-> 99 5 2
99 4 3 <-> 0 5 7
0 4 5 <-> 99 5 1
77 12 3 <-> 79 14 7
78 12 3 <-> 80 14 7
88 18 2 <-> 92 18 6
92 18 2 <-> 96 18 6
96 18 2 <-> 3 13 5
3 13 1 <-> 11 8 5
12 9 6 <-> 88 17 2
89 16 1 <-> 1 7 5
44 9 6 <-> 30 14 1
44 10 6 <-> 31 15 1
42 14 5 <-> 32 16 1
50 2 6 <-> 41 3 2
50 1 6 <-> 41 2 2
51 4 0 <-> 51 2 4
43 0 3 <-> 50 1 7
42 1 2 <-> 50 2 7
94 21 7 <-> 89 20 2
88 21 2 <-> 93 22 6
94 22 7 <-> 89 20 3