5
0
0 0 
10 11
- - 3 4 5 - - - - - - 
- - 0 0 0 - - - - - - 
- - 0 1 0 - - 2 - - - 
- - 0 2 0 - - 2 - - - 
- 1 0 2 0 - - 1 - - - 
- - 2 - - - - - - - - 
1 2 2 i 2 2 2 - 2 2 1 
- - 2 2 2 - - - - - - 
- 1 0 2 0 2 - - - - - 
- - - 1 - - 2 - - - - 
3 4 4 <-> 3 6 0 
6 6 2 <-> 8 6 6 
6 9 3 <-> 7 2 0