2
0
0 0 
10 11
- - 0 0 0 - - - - - - 
- - 0 0 0 - - - - - - 
- - 0 1 0 - - 2 - - - 
- - 0 2 0 - - 2 - - - 
- 1 0 2 0 - - 1 - - - 
- - 1 - - - - - - - - 
1 1 1 c 2 - 2 - 2 2 1 
- - 1 1 2 - - - - - - 
- 1 0 1 0 2 - - - - - 
- - - 1 - - 2 - - - - 
3 4 4 <-> 3 6 0 
6 6 2 <-> 8 6 6 
4 6 2 <-> 6 6 6 
6 9 3 <-> 7 2 0