2
2
1 2
10 20
- - - - - - - - - - - - - - - - - - - -
- - - - - - - - - 0 0 - - - - - - - - -
- - - - - - - - 0 0 0 0 - - - - - - - -
- - 0 0 0 0 0 0 0 1 2 0 0 0 0 0 0 0 - -
- - - - 0 0 0 0 0 2 1 0 0 0 0 0 - - - -
- - - - - 0 0 0 0 0 0 0 0 0 0 - - - - -
- - - - - 0 0 0 0 0 0 0 0 0 0 - - - - -
- - - - 0 0 0 0 0 - - 0 0 0 0 0 - - - -
- - - 0 0 0 - - - - - - - - 0 0 0 - - -
- - - - - - - - - - - - - - - - - - - -
2 3 6 <-> 17 3 2