4
3
2 2
20 40
- - - - - - - - - - - - - - - - - - - - - - - - - - - - - - - - - - - - - - - -
- - - - - - - - - - - - 0 0 0 0 0 0 0 0 0 0 0 0 0 0 0 0 - - - - - - - - - - - -
- - - - - - - - 0 0 0 0 0 0 0 0 0 0 0 0 0 0 0 0 0 0 0 0 0 0 0 0 - - - - - - - -
- - - - - - 0 0 0 0 0 0 0 0 0 0 0 0 0 0 0 0 0 0 0 0 0 0 0 0 0 0 0 0 - - - - - -
- - - - 0 0 0 0 0 0 0 0 - - - - 0 0 0 0 0 0 0 0 - - - - 0 0 0 0 0 0 0 0 - - - -
- - - 0 0 0 0 0 0 0 0 0 - - - - - 0 0 3 4 0 0 - - - - - 0 0 0 0 0 0 0 0 0 - - -
- - 0 0 0 0 0 0 0 0 0 - - - - - - 0 3 1 2 4 0 - - - - - - 0 0 0 0 0 0 0 0 0 - -
- 0 0 0 0 0 0 0 0 0 0 - - - - - - 0 1 3 4 2 0 - - - - - - 0 0 0 0 0 0 0 0 0 0 -
- 0 0 0 0 0 0 0 0 0 0 0 - - - - - 0 0 1 2 0 0 - - - - - 0 0 0 0 0 0 0 0 0 0 0 -
- 0 0 0 0 0 0 0 0 0 0 0 0 - - - 0 0 0 0 0 0 0 0 - - - 0 0 0 0 0 0 0 0 0 0 0 0 -
- 0 0 0 0 0 - - - 0 0 0 0 0 0 0 0 0 0 0 0 0 0 0 0 0 0 0 0 0 0 - - - 0 0 0 0 0 -
- 0 0 0 0 0 - - - - - 0 0 0 0 0 0 0 0 0 0 0 0 0 0 0 0 0 0 - - - - - 0 0 0 0 0 -
- 0 0 0 0 0 - - - - - - - - 0 0 0 0 0 0 0 0 0 0 0 0 - - - - - - - - 0 0 0 0 0 -
- - 0 0 0 0 0 - - - - - - - - - - - - - - - - - - - - - - - - - - 0 0 0 0 0 - -
- - - 0 0 0 0 0 - - - - - - - - - - - - - - - - - - - - - - - - 0 0 0 0 0 - - -
- - - - 0 0 0 0 0 0 - - - - - - - - - - - - - - - - - - - - 0 0 0 0 0 0 - - - -
- - - - - - 0 0 0 0 0 0 0 - - - - - - - - - - - - - - 0 0 0 0 0 0 0 - - - - - -
- - - - - - - - 0 0 0 0 0 0 0 0 0 0 0 0 0 0 0 0 0 0 0 0 0 0 0 0 - - - - - - - -
- - - - - - - - - - - - 0 0 0 0 0 0 0 0 0 0 0 0 0 0 0 0 - - - - - - - - - - - -
- - - - - - - - - - - - - - - - - - - - - - - - - - - - - - - - - - - - - - - -
10 6 2 <-> 17 6 6
22 6 2 <-> 29 6 6
10 7 2 <-> 17 7 6
22 7 2 <-> 29 7 6